TGGGGGGGGGGGGGGGGGGGG
GGGGGGGGGGGGGGGGGGGGW
GGGGGGGGGGGGGGGGGGGGW
WGGGGGGGGGGGGGGGGGGGW
WGGGGGGGGGGGGGGGGGGGW
WGGGGGGGGGGGGGGGGGGGW
WGGGGGGGGGGGGGGGGGGGW
WGGGGGGGGGGGGGGGGGGGW
WGGGGGGGGGGGGGGGGGGGW
WGGGGGGGGGGGWGGGGGGGW
WGGGGGGGGGGWWWGGGGGGW
WGGGGGGGGGGGGGGGGGGGW
WGGGGGGGGGGGGGGGGGGGW
WGGGGGGGGGGGGGGGGGGGW
WGGGGGGGGGGGGGGGGGGGW
WGGGGGGGGGGGGGGGGGGGW
WGGGGGGGGGGGGGGGGGGGW
WGGGGGGGGGGGGGGGGGGGW
WGGGGGGGGGGGGGGGGGGGW
WGGGGWGGGGGGGGGGGGGGW
WWWWWWWWWWWWWWWWWWWWW