WWWWWWWWWWWWWWWWWWWWW
WGGGGGGGGGGGGGGGGGGGW
WGGGGGGGGGGGGGGGGGGGW
WGGGGGGGGGGGGGGGGGGGW
WGGGGGGGGGGGGGGGGGGGW
WGGGGGGGGGGGGGGGGGGGW
WGGGGGGGGGGGGGGGGGGGW
WGGGGGGGGGGGGGGGGGGGW
WGGGGGGGGGGGGGGGGGGGW
WGGGGGGGGGGGGGGGGGGGW
WGGGGGGGGGGGGGGGGGGGW
WGGGGGGGGGGGGGGGGGGGW
WGGGGGGGGGGGGGGGGGGGW
WGGGGGGGGGGGGGGGGGGGW
WGGGGGGGGGGGGGGGGGGGW
WGGGGGGGGGGGGGGGGGGGW
WGGGGGGGGGGGGGGGGGGGW
WGGGGGGGGGGGGGGGGGGGW
WGGGGGGGGGGGGGGGGGGGW
WGGGGGGGGGTGGGGGGGGGW
WWWWWWWWWWWWWWWWWWWWW