TGGGGGGGGGGGGGGGGGGGG
GWWWWWWWWWWGGGGGGGGGW
GWWGGGGGGGGGGGGGGGGGW
GWGWGGGGGGGGGGGGGGGGW
GWGGWGGGGGGGGGGGGGGGG
GWGGGWGGGGGGGGGGGGGGG
GWGGGGWGGGGGGGGGGGGGG
GWGGGGGWGGGGGGGGGGGGG
GWGGGGGGWGGGGGGGGGGGG
GWGGGGGGGWGGGGGGGGGGG
GWGGGGGGGGWGGGGGGGGGG
GGGGGGGGGGGWGGGGGGGGG
GGGGGGGGGGGGGGGGGGGGG
GGGGGGGGGGGGGGGGGGGGG
GGGGGGGGGGGGGGGGGGGGG
GGGGGGGGGGGGGGGGGGGGG
GGGGGGGGGGGGGGGGGGGGG
GGGGGGGGGGGGGGGGGGGGG
GGGGGGGGGGGGGGGGGGGGG
GGGGGGGGGGGGGGGGGGGGG
GWWWWWWWWWWWWWWWWWWWG