WWWWWWWWWWWWWWWWWWWWW
WGGGGGGGGGGGGGGGGGGGW
WGGGGGGGGGGGGGGGGGGGW
WGGGGGGGGGGGGGGGGGGGW
WGGGGGGGGGGGGGGGGGGGW
WGGGGGGGGGGGGGGGGGGGW
WGGGGGGGGGGGGGGGGGGGW
WGGGGGGGGGGGGGGGGGGGW
WGGGGGGGGGGGGGGGGGGGW
WGGGGGGGGGGGGGGGGGGGW
WGGGGGGGGGGGGGGGGGGGW
WGGGGGGGGGGGGGGGGGGGW
WGGGGGGGGGGGGGGGGGGGW
WGGGGGGGGGGGGGGGGGGGW
WGGGGGGGGGGGGGGGGGGGW
WGGGGGGGGGGGGGGGGGGGW
WGGGGGGGGGGGGGGGGGGGW
WGGGGGGGGGGGGGGGGGGGW
WGGGGGGGGGGGGGGGGGGGW
WGGGGWGGGGTGGGGGGGGGW
WWWWWWWWWWWWWWWWWWWWW